11111111111111111111111
1E00C00000C0000001K0001
100001010010CCC00010101
11010K010010010K0010101
1C00P000000000000000C11
11111111111111111111111