1111111111111
10011110000C1
10001C1111001
1P0011E0C0001
1111111111111